[
    { "x": 1, "y": 1 },
    { "x": 1, "y": 2 },
    { "x": 2, "y": 2 },

    { "x": 7, "y": 1 },
    { "x": 8, "y": 1 },
    { "x": 8, "y": 2 },
    
    { "x": 5, "y": 5 },

    { "x": 1, "y": 8 },
    { "x": 2, "y": 7 },

    { "x": 8, "y": 8 }

]