[
    { "x": 2, "y": 2 },
    { "x": 3, "y": 2 },
    { "x": 3, "y": 3 },

    { "x": 7, "y": 4 },
    { "x": 7, "y": 5 },
    { "x": 8, "y": 5 },
    { "x": 9, "y": 5 },

    { "x": 2, "y": 8 }

    
]